
--------------------F---------------------
--------------------*---------------------
---***--***-**--***-*****-***-**---****---
----**-**-***-***-*-*---***-**-*--*-*-----
----****-*--*-**-*-*-**-----**-*-******---
---**-*----**--*-***-***-**-**-***-*--*---
------****-*--****-*-*-*--*-*-*----***----
---***--*--**--*---***-S*-***-*****--**---
---*-*****--**--***---**----***---****----
---**----***-*-**-*-***--***---***---**---
---******-*-*-**--***--***-*-***-*-**-*---
---*----*--***---**--***-*-***---***-**---
----***-****-****--***-**-*---***---**----
----*-****-****-*-***--****-***-***-*-*---
---**-*-*-*-***-***-**-*--***---*-*****---
------------------------------------------
------------------------------------------
